melon=mel·on
melodrama=mel·o·dra·ma
melodramatic=mel·o·dra·mat·ic
melody=mel·o·dy
melody=mel·o·dy
member=mem·ber
member=mem·ber
membership=mem·ber·ship
membrane=mem·brane
membranous=mem·bra·nous
memo=mem·o
memoir=mem·oir
memoirs=mem·oirs
parker=par·ker
parkinson=par·kin·son
parlance=par·lance
parlay=par·lay
parley=par·ley
parley=par·ley
parleyed=par·leyed
parleyer=par·ley·er
parleying=par·ley·ing
parliament=par·lia·ment
parliament=par·lia·ment
parliamentarian=par·lia·men·tar·i·an
parliamentarian=par·lia·men·tar·i·an
parliamentary=par·lia·men·ta·ry
parlor=par·lor
parlous=par·lous
parlously=par·lous·ly
parmigiana=par·mi·gia·na
paroxysm=par·ox·ysm
paroxysmal=par·ox·ys·mal
shingles=shin·gles
shining=shin·ing
shinier=shin·i·er
shiniest=shin·i·est
shinily=shin·i·ly
shininess=shin·i·ness
shinnied=shin·nied
shinning=shin·ning
shinny=shin·ny
shinnying=shin·ny·ing
shiny=shin·y
ship=ship
than=than
thane=thane
thank=thank
thanks=thanks
thanksgiving=thanks·giv·ing
thanker=thank·er
thankful=thank·ful
thankfully=thank·ful·ly
thankless=thank·less
that=that
thatch=thatch
thatch=thatch
thatching=thatch·ing
thatcher=that·cher
animater=an·i·mat·er
animism=an·i·mism
anklet=an·klet
announce=an·nounce
annoying=an·noy·ing
annul=an·nul
